######        ######
#              #    
#              #    
#    ######    #  
       ######      
          #####    
#      ######      #
#      @           #
#                  #
########    ########